17 39
-----------@---@-----@-----------@-@-@-
-@-@-@@@-@@@-@-@-@@@@@@@-@@@-@@@@@-@-@-
-@-@-@-@---@-@-@-@-@-@-@-@-----@-------
@@-@@@-@@@@@-@@@-@-@-@-@@@@@@@-@@@@@-@@
-------@---------@-@---------@---------
-@-@-@@@@@@@@@@@-@-@-@@@-@@@-@@@-@@@-@@
-@-@-----------@---@-@-----@-@-----@---
@@@@@@-@@@-@@@@@-@@@-@@@@@-@-@-@-@-@@@-
-----@---@-----@---------@-@-@-@-@-@---
@@-@-@@@@@@@-@-@@@@@@@@@@@-@@@-@-@-@-@@
-@-@-------@-@---@-@---@-------@-@-@-@-
-@@@-@-@@@@@-@-@-@-@-@@@-@@@@@-@-@@@-@-
-----@-@---@-@-@-@-@-----@-@---@-@---@-
@@@@-@@@-@-@-@-@@@-@-@@@-@-@@@@@@@-@-@-
-------@-@---@-@-@---@---@-@-@-----@---
-@-@-@@@@@-@-@@@-@-@@@@@-@-@-@-@@@@@-@-
-@-@-------@-------@-----@-----@-----@-
