17 41
---@---@---@-----@-@-----@---@-----@-@-@-
-@@@-@-@-@@@@@-@-@-@@@-@@@-@-@-@@@-@-@-@-
---@-@---------@-----@-@---@---@-@-----@-
-@@@@@-@-@@@@@@@-@@@-@-@@@@@@@-@-@@@-@-@-
-@---@-@-------@-@---@-@---@-@---@-@-@---
-@-@-@@@@@-@@@-@@@-@@@-@@@-@-@-@-@-@@@@@-
-@-@-------@-@-@---@-----@-----@---@-@---
-@-@-@@@@@@@-@@@@@-@-@-@@@@@-@-@@@@@-@@@-
---@-------------@-@-@---@-@-@---@---@---
-@-@-@@@@@@@@@@@-@-@-@-@@@-@@@@@@@-@@@@@-
-@-@---@---@---@-@-@-@-------@-@-------@-
-@@@@@@@-@@@-@@@-@@@-@@@@@-@-@-@-@@@@@-@-
-@-------@-----@---------@-@-@-------@-@-
-@@@-@@@@@@@-@-@@@-@@@-@@@-@@@@@@@-@@@-@-
-@-------@---@---@---@-@-@---------@---@-
@@@@@@-@@@@@@@@@-@@@-@-@-@@@-@@@-@@@@@@@-
---------------------@-----@---@---------
