19 35
-----------@-------@---@---@-@-@-@-
-@-@@@@@@@-@@@-@@@@@-@@@-@-@-@-@-@-
-@---@---------@-----@-@-@-@-------
-@@@-@@@@@@@@@-@-@@@@@-@-@@@-@-@-@@
---@-@---@-------@-----@-----@-@---
@@@@@@-@-@-@@@@@@@-@@@@@-@@@@@-@@@-
-------@-----@---@-@-@-@---@---@---
@@@@@@-@-@@@-@-@@@-@-@-@@@@@-@@@-@-
---@---@-@-------@-@---@-------@-@-
-@@@-@@@-@@@@@@@-@-@@@-@-@@@@@@@@@-
---@-@-------@-----@-@-@-@-@---@-@-
-@-@-@-@-@@@@@-@@@@@-@-@@@-@@@-@-@-
-@---@-@---@-@-----@-@-------@-@---
@@-@@@-@@@-@-@@@@@-@-@-@@@-@@@-@-@@
-----@-@-------@-----@-@-----------
-@@@-@@@@@-@@@@@-@@@-@@@@@@@-@-@@@-
-@---@---@---@-----@-@-@-----@---@-
-@-@@@@@-@-@@@-@-@@@-@-@-@-@@@-@-@@
-@-------@---@-@-@-------@-@---@---
