21 13
-----------@-
@@-@@@@@@@@@-
-------------
-@@@@@-@@@@@-
-@-----@-@-@-
-@-@@@@@-@-@-
-@-@---------
-@@@-@-@@@@@-
-@-@-@-@-@---
@@-@@@-@-@-@@
---@---@---@-
@@-@-@@@@@-@-
---@-@-@---@-
-@-@-@-@-@@@-
-@-@---@-----
@@-@-@@@-@-@@
-------@-@---
@@-@-@-@@@@@-
---@-@-@-@---
-@@@-@@@-@@@-
-@---------@-
