21 35
-@-@-----@-------@---@-@-------@-@-
-@-@-@@@@@-@@@@@@@-@-@-@-@-@@@-@-@-
-------------@-@---@-@---@---@-----
@@@@@@-@@@-@-@-@@@-@-@-@@@@@@@-@@@@
-------@---@-----@-@---@---@-----@-
@@-@@@-@@@-@@@@@@@@@@@-@-@@@-@-@@@-
---@---@-@-@-----@-@---@-@---@-@-@-
@@-@-@@@-@-@@@-@@@-@@@@@-@-@-@@@-@-
---@-@---------@---@-------@-----@-
-@@@@@@@@@-@@@@@@@-@@@-@-@-@@@-@@@-
---------@-------@---@-@-@-@-@---@-
-@@@-@@@@@@@@@-@@@-@@@-@-@-@-@@@@@-
-@---@-----------@-@---@-@---------
@@@@@@-@-@-@-@@@@@-@@@@@@@@@@@@@-@-
-------@-@-@-@-----@---@-----@---@-
@@@@@@-@-@@@@@@@@@-@@@-@@@@@-@-@-@@
-----@-@-@---------@---@-----@-@---
-@@@@@@@-@-@-@@@-@-@@@-@-@@@-@-@@@-
-----@---@-@---@-@-@-@-----@-----@-
-@@@-@-@@@@@-@-@@@-@-@-@-@@@@@@@-@@
-@-----------@---@-----@---@-------
