21 37
-@-------------@-------@---@---------
-@@@-@@@@@-@@@-@-@@@-@@@@@-@@@@@-@-@-
-----@-@-----@-@---@---------@---@-@-
@@@@@@-@@@@@@@-@@@@@@@-@@@@@@@@@-@@@@
-------@---@-@---@-------@-----------
-@@@@@-@-@@@-@@@-@-@@@@@-@-@-@@@@@@@-
-----@---@---@-----@-@---@-@---@-@---
@@@@@@@@-@-@@@@@-@@@-@@@-@-@@@@@-@-@-
-----@-----@-@---@---@---@-----@---@-
-@@@@@@@-@@@-@-@@@@@-@-@@@-@-@@@-@-@@
---@-------@-----@---@-----@---@-@---
-@@@-@-@-@@@@@@@-@-@@@-@@@@@-@@@@@@@@
-----@-@-@-@---@-@-@-@-@---@-@---@---
@@@@@@@@-@-@-@-@@@-@-@-@@@-@@@-@@@-@@
-----@-@-----@-------------@---@-@-@-
-@-@@@-@-@@@@@@@@@@@@@-@-@-@@@-@-@-@-
-@-----------@-@---@---@-@-@-@---@---
@@-@-@@@-@@@@@-@-@-@@@@@-@-@-@-@-@@@-
---@---@-------@-@-----@-@-----@-----
-@-@-@-@-@-@@@@@-@-@@@-@@@@@@@@@@@-@-
-@-@-@-@-@-------@---@-@-----------@-
