25 15
---@-----@-----
-@@@@@-@-@-@-@@
-------@---@---
@@@@-@-@-@-@@@@
---@-@-@-@-----
@@-@-@-@-@-@-@@
---@-@-@-@-@---
-@-@-@@@@@@@@@-
-@---@-@-----@-
@@@@@@-@-@-@@@-
-@---@---@---@-
-@-@@@-@-@@@-@-
---@---@-@-@-@-
-@-@-@@@@@-@-@-
-@-----@---@---
-@@@-@-@@@-@@@-
---@-@---@-----
-@@@@@@@@@-@-@@
-@-@-----@-@---
-@-@@@@@-@-@-@-
-------@-@-@-@-
@@-@@@@@-@@@-@-
-----------@-@-
-@@@@@@@-@-@@@@
-----@---@-----
